5 11
|||||||||||
|.F.|.....|
|......@P.|
|.F.......|
|||||||||||